#,#,#,#,#,#,#,#,#,#,#,#,#,#,#,#,#,#,#,#,#,#,#,#,#,#,#,#,#,#,#,#,#,#,#,#,#,#,#,#,#,#,#,#,#,#,#,#,#,#,#
#,,,,o,,,,,,,,,%,@,o,o,,,%,@,,,,,,,,o,,%,@,o,,o,,o,@,%,o,o,o,o,%,%,%,o,o,o,@,#
#,,,,,o,,,,,,,,%,%,o,,,@,%,,,,,,,,,,,%,,,o,,o,,,%,,o,o,o,%,,%,o,o,o,,#
#,@,,%,%,%,o,,,,,,,@,%,,,@,@,%,,,,,,,,,o,,%,,,,,,,,%,,,,o,,S,,o,,,,#
#,,,%,X,A,%,,,,,,@,,%,,,%,%,%,,,,,,,,,,,%,,,,,,,,%,,,,,%,X,%,,,,,#
#,,,%,X,X,X,%,,,,@,,,%,,,%,o,o,,,,,,,,,,,%,,,,@,,,,%,,,o,%,%,X,%,%,o,,,#
#,,o,%,,,,%,,%,%,%,%,%,%,,,%,o,,,,,%,%,%,%,,@,,%,,,,%,,,,%,,,,o,,X,,@,,,,#
#,,@,%,,o,,%,,,,o,,,,,,,,,,,,%,@,@,%,,,,%,,,,%,,,,%,,,,,,X,,,,,,#
#,,,%,,,%,,,,o,,,,,,,,,,,,%,%,,,%,,o,,%,,,,%,,,,%,,,o,%,%,X,%,%,o,,,#
#,,,%,@,@,o,,,o,,,,,,,,,,,,,%,,,o,%,,,,%,,,,%,,,,%,,,,@,,X,,o,,,,#
#,o,,%,@,@,o,,,,,,%,,,,%,%,o,,%,%,%,,,o,%,,,,%,,,,%,,,,%,,,,,,X,,,,,,#
#,@,,%,,,%,,,,,,%,,,,%,,,,,@,%,,,o,%,,@,,%,@,,o,%,o,,@,%,o,,o,%,%,X,%,%,,,o,#
#,,,%,,o,,%,,,,,%,%,%,%,%,,,,,,,,,o,%,,,,,,,,%,,,,o,,,,o,,X,,@,,,,#
#,,,%,,@,,%,,,,,%,,,@,%,,,,,,,,%,%,%,,,,,,,,%,,,,,,,,,,X,,,,,,#
#,,,%,X,X,X,%,,,,@,,,,,%,%,%,,,,%,%,%,@,%,,,,o,,,,%,,,,,,,,%,%,X,%,%,,,,#
#,,o,%,X,A,%,,,,@,,,,,,,@,%,,,,,o,,,%,,,,,,,,%,o,,,,,,,@,%,X,%,@,,,,#
#,,@,%,%,%,,,,@,,,,,,,,,%,o,,,,,,,%,,o,,,,,o,%,o,o,o,o,,,,,,o,,,,o,@,#
#,#,#,#,#,#,#,#,#,#,#,#,#,#,#,#,#,#,#,#,#,#,#,#,#,#,#,#,#,#,#,#,#,#,#,#,#,#,#,#,#,#,#,#,#,#,#,#,#,#,#
