#,#,#,#,#,#,#,#,#,#,#,#,#,#,#,#,#,#,#,#,#,#,#,#,#,#,#,#,#,#
#,o,o,,,,,,,,,,o,o,%,,,,@,o,@,,,,,,,o,o,#
#,o,@,,,,,o,%,o,,,@,o,%,,,,o,o,o,,,,,,,@,o,#
#,,,,,,,%,%,%,,,,,%,,,,,%,,,,,@,,,,,#
#,,,,,,,o,%,o,,,,,%,,,,%,%,%,X,X,X,X,X,,,,#
#,,,,,,,,X,,,,,,%,,,,@,%,@,,,,@,X,@,,,#
#,,,,,,,,X,,,,,,%,,,,,,,,,,,X,,,,#
#,,,,X,X,X,X,X,,,,,@,%,@,,,,,,,,,,%,,,,#
#,,,,X,,,,,,o,o,o,o,%,o,o,o,o,,,,,,%,%,%,,,#
#,,,,X,,,,,,o,X,X,A,%,A,X,X,o,,,,,,,%,,,,#
#,,,,%,,,,,,o,X,%,%,%,%,%,X,o,,,,,o,,,,,,#
#,,@,%,%,%,@,,,,o,X,X,X,X,X,X,X,o,,,,o,o,o,,,,o,#
#,,,,%,,,,,,o,o,o,o,o,o,o,o,o,,,,,%,,,,o,o,#
#,,,,X,,,,,,,,,@,X,@,,,,,,,%,%,%,,,,o,#
#,@,,,X,,,,,,,,,,X,,,,,,,,,%,,,,,,#
#,,,,X,,,,,,,,,@,%,@,,,,,,,,X,,,,,,#
#,,,,X,X,X,X,X,X,X,X,X,%,%,%,,,,,,,X,X,,,,,,#
#,,,,,,,@,,,,,,,%,,,,,,,@,X,@,,,,,,#
#,,,,,,,,,,,,,,,,,,,,,,X,,,,,,,#
#,,,,,,,,,,,,,,,,,,,,,,%,,,,,,,#
#,,o,,,,,,,@,,,o,,S,,o,,,,,%,%,%,,,,o,,#
#,%,%,o,,,,,,,,,%,%,%,%,%,,,,,@,%,@,,,o,%,%,#
#,,o,,,,,,,,,,,@,%,,,,,,,,,,,,,o,,#
#,,,@,,,,,,o,,,,,%,,,,,,,,,,,,,,,#
#,,,,,,,,o,o,o,,,,%,,,,,,,,,,,,,,,#
#,,,o,,,,,,%,,,,,%,,,,,o,,,,,,,,,,#
#,,o,o,o,,X,X,%,%,%,,,,%,,,,o,o,o,,,,,,,@,,#
#,,,%,,,X,,@,%,@,,,@,%,,,,,%,,,,@,,,,,,#
#,,%,%,%,X,X,,,,,,,o,%,,,,%,%,%,,,,,,,,o,#
#,,,%,,,,,,,,,o,o,%,,,,,%,,,,,,,,o,o,#
#,,,,,,,,,,,o,o,o,%,,,,,@,,,,,,@,o,o,o,#
#,#,#,#,#,#,#,#,#,#,#,#,#,#,#,#,#,#,#,#,#,#,#,#,#,#,#,#,#,#
