#,#,#,#,#,#,#,#,#,#,#,#,#,#,#,#,#,#,#,#,#,#,#,#,#,#,#,#,#,#
#,A,X,X,X,X,X,%,,@,,@,,@,,,%,,,o,o,o,,,%,X,X,X,A,#
#,,o,,o,,o,%,%,,,,,,,,%,%,,,,,,,%,%,o,o,o,#
#,o,,o,@,o,,,%,%,,,,,,,,%,%,,,,,,,%,%,,,#
#,,,@,,@,,,,,,,,,o,,o,,o,,,,,,,,,@,@,#
#,,,,,,,,,@,,,,o,,o,,o,,,,,,,,,,o,,#
#,,,,,,,,,,,,,,,,,,,,,,,,,,,o,,#
#,,,,,o,,,,@,,,,,,,,,,,,,o,,,,,,,#
#,,,,@,,,,,,,,,,,,,,,,,,o,,,,,,,#
#,,,o,,,,,,%,,,,%,@,,,,,,,,,,,,,,,#
#,,@,,,,,,%,%,,S,,%,%,,,,,,,,,,,@,,,,#
#,,,,,o,,%,%,,,,,,%,%,,,,,,,,,,%,%,,o,#
#,,,,,,%,%,,,,,,,@,%,%,,,,,,,,%,%,,,,#
#,%,%,%,%,%,%,,,,,o,,,,@,%,%,,o,,,,%,%,,,,o,#
#,@,o,@,o,@,o,,,,,,,,,,,,,o,,,%,%,,,,,,#
#,o,,o,,o,,,,,,o,,,,,,,,@,@,,@,%,,,,,o,#
#,,,,,,,,,,,,@,@,,,,,,,,,,%,,,,,,#
#,,,,,,,,,,o,,,,o,,,,,,,,,%,,,o,,o,#
#,,,,,,,,,,,,,,,,,,,,,,,%,%,%,%,%,%,#
#,,,,,,,,,,,,,,,,,,,,,,,,,,,,,#
#,,,,,%,%,,,,,o,,,,,%,%,,,,o,,,,o,,,,#
#,,,,,@,%,%,,,,,,,,%,%,,,,,o,@,,,,,,,#
#,,o,,o,,o,%,%,,,,,,%,%,@,,,,,,,,,,,,,#
#,o,,o,,o,,@,%,%,,,,%,%,@,,,,,,,,,,,o,,,#
#,,,,,,,,@,%,,,,%,@,,,,,,,,,,,,,,,#
#,,,,,,,,,,,,,,,,,,,,,,,,,,,,,#
#,%,@,,,,,,,,,,,,,,,,,o,,,,,,,,,,#
#,%,%,@,,,,,,o,,,,,,o,,,,o,,,,,%,%,o,,o,#
#,@,%,%,,,,,,,,,,,,,,,,,,,,%,%,,,@,,#
#,,,,,,,,,,,,o,,,,,,,,,,%,%,,,,,,#
#,,,,,o,,,,,,@,,,,,,@,,,@,%,%,X,X,X,X,X,A,#
#,#,#,#,#,#,#,#,#,#,#,#,#,#,#,#,#,#,#,#,#,#,#,#,#,#,#,#,#,#
